width=20
height=10
bitmaps=3
attribute0=1
attribute0.noSpace=1
attribute0.damage=0.0f
attribute0.velocity=1.0f
attribute1=0
attribute2=1
attribute2.noSpace=0
attribute2.damage=0.25f;
attribute2.velocity=3.0f;
2,0,0,0,0,1,0,0,0,1,0,0,0,0,0,0,0,1,2,2
2,2,1,1,0,1,0,1,1,1,2,2,2,2,2,2,2,2,2,2
1,2,1,1,1,1,1,1,2,1,2,2,2,2,2,2,2,2,2,2
1,1,2,1,1,1,1,1,0,1,0,0,0,0,2,2,1,0,1,2
2,0,0,0,1,1,1,1,0,1,1,0,0,0,0,0,0,1,0,2
2,2,1,1,0,1,0,1,1,1,2,2,2,2,2,2,2,2,2,2
2,2,1,1,0,1,0,1,1,1,2,2,2,2,2,2,2,2,2,2
2,0,0,0,0,1,0,0,0,1,0,0,0,0,0,0,0,1,2,2
2,0,0,0,1,1,1,1,0,1,1,0,0,0,0,0,0,1,0,2
2,0,0,0,0,1,0,0,0,1,0,0,0,0,0,0,0,1,2,2